5 8
11101110
11000110
11010110
11000010
00011000
0 7
4 0




